// Erklärung unzerstörbare Blöcke
[DIM]
17,9;
[LEVEL]
2,2,2,2,2,2,2,2,2,2,2,2,2,2,2,2,2;
2,0,0,0,0,0,0,0,0,0,0,0,2,0,0,0,2;
2,0,0,0,2,2,2,2,0,2,0,0,2,0,3,0,2;
2,0,0,0,2,0,0,0,0,2,0,0,2,0,0,0,2;
2,0,2,0,2,0,2,2,2,2,0,0,2,2,0,2,2;
2,0,2,0,2,0,2,0,0,0,0,0,0,2,0,2,2;
2,0,2,2,2,0,2,2,2,2,2,2,2,2,0,2,2;
2,0,0,0,0,0,0,0,0,0,0,0,0,0,0,2,2;
2,2,2,2,2,2,2,2,2,2,2,2,2,2,2,2,2;
