// Item Erklärung. Items müssen noch hinzugefügt werden.
[DIM]
17,9;
[LEVEL]
2,2,2,2,2,2,2,2,2,2,2,2,2,2,2,2,2;
2,0,0,2,0,0,0,0,0,0,0,0,0,0,0,0,2;
2,0,0,2,0,0,0,0,0,0,0,0,0,0,3,0,2;
2,0,0,1,0,0,0,0,0,0,0,0,0,0,0,0,2;
2,0,0,1,0,0,0,0,0,0,0,0,0,0,0,0,2;
2,0,0,1,0,0,0,0,0,0,0,0,0,0,0,0,2;
2,0,0,2,0,0,0,0,0,0,0,0,0,0,0,0,2;
2,0,0,2,0,0,0,0,0,0,0,0,0,0,0,0,2;
2,2,2,2,2,2,2,2,2,2,2,2,2,2,2,2,2;
