// Gegnererklärung. Gegner muss noch hinzugefügt werden.
[DIM]
17,9;
[LEVEL]
2,2,2,2,2,2,2,2,2,2,2,2,2,2,2,2,2;
2,0,0,0,0,0,0,0,0,0,0,0,0,0,0,0,2;
2,0,0,0,0,0,5,0,0,0,5,0,0,0,3,0,2;
2,0,0,0,0,0,0,0,0,0,0,0,0,0,0,0,2;
2,0,0,0,0,0,0,0,0,0,0,0,0,0,0,0,2;
2,0,0,0,0,0,0,0,0,0,0,0,0,0,0,0,2;
2,0,0,0,0,0,6,0,0,0,6,0,0,0,0,0,2;
2,0,0,0,0,0,0,0,0,0,0,0,0,0,0,0,2;
2,2,2,2,2,2,2,2,2,2,2,2,2,2,2,2,2;
